"filename", "language", "JSON", "JavaScript", "Markdown", "comment", "blank", "total"
"c:\Users\Chirag\Desktop\Url_Shortener\Readme.md", "Markdown", 0, 0, 37, 0, 7, 44
"c:\Users\Chirag\Desktop\Url_Shortener\package-lock.json", "JSON", 1707, 0, 0, 0, 1, 1708
"c:\Users\Chirag\Desktop\Url_Shortener\package.json", "JSON", 25, 0, 0, 0, 1, 26
"c:\Users\Chirag\Desktop\Url_Shortener\src\api\url.js", "JavaScript", 0, 22, 0, 1, 5, 28
"c:\Users\Chirag\Desktop\Url_Shortener\src\app.js", "JavaScript", 0, 9, 0, 0, 3, 12
"c:\Users\Chirag\Desktop\Url_Shortener\src\config\index.js", "JavaScript", 0, 7, 0, 0, 2, 9
"c:\Users\Chirag\Desktop\Url_Shortener\src\core\Api404Error.js", "JavaScript", 0, 13, 0, 0, 2, 15
"c:\Users\Chirag\Desktop\Url_Shortener\src\core\Api422Error.js", "JavaScript", 0, 13, 0, 0, 2, 15
"c:\Users\Chirag\Desktop\Url_Shortener\src\core\baseError.js", "JavaScript", 0, 12, 0, 2, 1, 15
"c:\Users\Chirag\Desktop\Url_Shortener\src\core\httpStatusCodes.js", "JavaScript", 0, 7, 0, 0, 1, 8
"c:\Users\Chirag\Desktop\Url_Shortener\src\data-access\url.js", "JavaScript", 0, 43, 0, 1, 4, 48
"c:\Users\Chirag\Desktop\Url_Shortener\src\database\models\url.js", "JavaScript", 0, 18, 0, 1, 4, 23
"c:\Users\Chirag\Desktop\Url_Shortener\src\helpers\schema.js", "JavaScript", 0, 14, 0, 0, 4, 18
"c:\Users\Chirag\Desktop\Url_Shortener\src\helpers\validator.js", "JavaScript", 0, 18, 0, 1, 2, 21
"c:\Users\Chirag\Desktop\Url_Shortener\src\server.js", "JavaScript", 0, 0, 0, 0, 1, 1
"c:\Users\Chirag\Desktop\Url_Shortener\src\service\url.js", "JavaScript", 0, 36, 0, 4, 4, 44
"Total", "-", 1732, 212, 37, 10, 44, 2035