"filename", "language", "JSON", "JavaScript", "Markdown", "comment", "blank", "total"
"c:\Users\Chirag\Desktop\Url_Shortener\Readme.md", "Markdown", 0, 0, 37, 0, 7, 44
"c:\Users\Chirag\Desktop\Url_Shortener\package-lock.json", "JSON", 1707, 0, 0, 0, 1, 1708
"c:\Users\Chirag\Desktop\Url_Shortener\package.json", "JSON", 25, 0, 0, 0, 1, 26
"c:\Users\Chirag\Desktop\Url_Shortener\src\api\url.js", "JavaScript", 0, 18, 0, 1, 5, 24
"c:\Users\Chirag\Desktop\Url_Shortener\src\app.js", "JavaScript", 0, 9, 0, 0, 3, 12
"c:\Users\Chirag\Desktop\Url_Shortener\src\config\index.js", "JavaScript", 0, 7, 0, 0, 2, 9
"c:\Users\Chirag\Desktop\Url_Shortener\src\core\APIErrors.js", "JavaScript", 0, 12, 0, 0, 1, 13
"c:\Users\Chirag\Desktop\Url_Shortener\src\data-access\url.js", "JavaScript", 0, 31, 0, 2, 4, 37
"c:\Users\Chirag\Desktop\Url_Shortener\src\database\models\url.js", "JavaScript", 0, 19, 0, 1, 4, 24
"c:\Users\Chirag\Desktop\Url_Shortener\src\helpers\schema.js", "JavaScript", 0, 14, 0, 0, 4, 18
"c:\Users\Chirag\Desktop\Url_Shortener\src\helpers\validation.js", "JavaScript", 0, 20, 0, 0, 1, 21
"c:\Users\Chirag\Desktop\Url_Shortener\src\server.js", "JavaScript", 0, 0, 0, 0, 1, 1
"c:\Users\Chirag\Desktop\Url_Shortener\src\service\url.js", "JavaScript", 0, 34, 0, 5, 3, 42
"Total", "-", 1732, 164, 37, 9, 37, 1979